107
10
2 6 6 6 6 6 0 0 0 0 0 0 0 0 0 0 0 0 0 0 0 0 0 0 0 0 0 0 0 0 0 0 0 0 0 0 0 0 0 0 0 0 0 2 6 6 6 6 6 6 6 6 6 6 6 6 6 6 6 6 6 6 6 6 6 6 6 6 6 6 6 6 6 6 6 4 0 0 0 0 0 0 0 0 0 0 0 0 0 0 2 6 6 6 6 6 6 6 6 6 6 6 6 6 6 6 6 
2 4 0 0 0 0 0 0 0 0 0 0 0 0 0 0 0 0 0 0 0 0 0 0 0 0 0 0 0 0 0 0 0 0 0 0 0 0 0 0 0 0 0 2 6 6 6 6 6 6 6 6 6 6 6 6 6 6 6 6 6 6 6 6 6 6 6 6 6 6 6 6 6 6 6 4 0 0 0 0 0 0 0 0 0 0 0 0 0 0 2 6 6 6 6 6 6 6 6 6 6 6 6 6 6 6 6 
2 4 0 0 0 0 0 0 0 0 0 0 0 8 3 5 8 0 0 0 0 0 0 0 0 0 0 0 0 0 0 0 0 0 0 0 0 0 0 0 0 0 0 0 0 0 0 0 0 6 6 6 6 6 6 6 6 6 6 6 6 6 6 6 6 6 6 6 6 6 6 6 6 6 6 4 0 0 0 0 0 0 0 0 0 0 0 0 0 0 2 6 6 6 6 6 6 6 6 6 6 6 6 6 6 6 6 
2 4 0 0 0 0 0 0 0 8 1 1 8 0 6 6 0 0 8 1 1 1 1 8 0 0 0 0 0 0 0 0 0 0 0 0 0 0 0 0 0 0 0 0 0 0 0 0 0 0 6 6 6 6 6 6 6 6 6 6 6 6 6 6 6 6 6 6 6 6 6 6 6 6 6 4 0 0 0 0 0 0 0 0 0 0 0 0 0 0 0 0 6 6 6 6 6 6 6 6 6 6 6 6 6 6 6
2 4 0 0 0 0 0 0 0 0 0 0 0 0 6 6 0 0 0 0 0 0 0 0 0 0 0 0 0 0 0 0 0 0 0 0 0 0 0 0 0 0 0 0 0 0 0 0 0 0 0 0 0 0 0 0 0 0 0 0 0 0 0 0 0 0 0 0 0 0 0 6 6 6 6 4 0 0 0 0 0 0 0 0 0 0 0 0 0 0 0 0 0 6 6 6 6 0 0 0 0 0 0 0 0 2 6 
2 4 0 0 0 0 0 0 0 0 0 0 0 0 6 6 0 0 0 0 0 0 0 0 0 0 0 0 0 0 0 0 0 0 0 0 0 0 0 0 0 0 0 0 0 0 0 0 0 0 0 0 0 0 0 0 0 0 0 0 0 0 0 0 0 0 0 0 0 0 0 0 0 0 0 0 0 0 0 0 0 0 0 8 3 1 5 8 0 0 0 0 0 0 0 0 0 0 0 0 0 0 0 0 0 2 6 
2 4 0 0 0 0 0 0 0 0 0 8 3 1 6 6 5 8 0 0 0 0 0 0 0 0 0 0 0 0 0 0 8 1 1 8 0 0 0 0 0 0 0 0 8 1 1 8 0 0 0 0 0 0 0 0 0 0 0 0 8 3 1 1 1 5 8 0 0 0 0 0 0 0 0 0 0 0 8 1 1 1 8 0 2 6 4 0 0 0 0 0 0 0 0 0 0 0 0 9 0 0 0 0 0 2 6 
2 4 0 0 0 0 0 0 0 8 3 1 6 6 6 6 4 0 0 0 0 0 0 0 0 0 0 0 0 0 0 0 0 0 0 0 0 0 0 0 0 0 8 3 1 6 6 1 5 8 0 0 0 0 0 0 0 0 0 0 0 2 6 6 6 4 0 0 0 0 0 0 0 0 0 0 0 0 0 0 0 0 0 0 2 6 4 0 0 0 0 0 0 0 0 0 0 0 0 0 0 0 0 0 0 2 6 
2 4 0 0 0 0 0 0 0 0 2 6 6 6 6 6 4 0 0 0 0 0 0 0 0 5 8 0 8 3 1 1 5 0 0 3 1 1 5 8 0 0 0 2 6 6 6 6 4 5 0 0 0 0 0 8 3 1 1 1 1 6 6 6 6 4 0 0 0 0 0 0 0 0 0 0 0 0 0 0 0 0 8 1 6 6 6 5 8 0 0 0 0 0 0 0 0 0 0 0 0 0 0 0 0 2 6 
6 6 1 1 1 1 1 1 1 1 6 6 6 6 6 6 4 0 0 0 0 0 0 0 6 4 1 1 1 6 6 6 6 1 1 6 6 6 4 0 0 0 0 2 6 6 6 6 6 6 1 1 1 1 1 1 6 6 6 6 6 6 6 6 6 4 0 0 0 0 8 3 1 1 1 1 1 1 1 1 1 1 1 1 6 6 6 6 1 1 1 1 1 1 1 1 1 1 1 1 1 1 1 1 1 1 6 
